default
WWWWWWW
WFFFFFW
WFFFFFW
WFFFFFW  WWWWW
WFFFFFWWWWFFFW
WFFFFFFFFFFFFW
WFFFFFWWWWFFFW
WFFFFFW  WWWWW
WWWWWWW