default
WWWWWWW
WFFFFFW
WFFFFFW
WFFFFFW  WWWWW
WFFFFFWWWWFFFW
WFFWFFFFFFFFFW
WFFFFFFFFFFFFW
WFFFFFWWWWWWWW
WWWWWWW