default
WWWWWWW
WFFFFFW
WFFFFFWWWW
WFFFFFFFFW
WFFFFFWWWW
WFFFXFW
WWWWWWW