default
WWWWWWWWWWWWWW
WFFFFFWWWWWFFW
WFFFFFFFFFFFFW
WFFFFFWWWWWFFW
WFFFFFWWWWFFFW
WFFWFFFFFFFFFW
WFFFFFFFFFFFFW
WFFFFFWWWWWWWW
WWWWWWW