levelOne
WWWWWWWWWWWWWW
WFFFFFWWWWWFFW
WFFFFFFFFFFFFW
WFFEFFWWWWWFFW
WFFFFFWWWWFFFW
WFFWFFFFFFFFFW
WFFFFFFFFSFFFW
WFFFFFWWWWWWWW
WWWWWWW