levelTwo
WWWWWWWWWWWWWW
WFFFFFFFFFFFFW
WFSFFFFFFFFFFW
WFFFFFFFFFFFFW
WFFFFFFFFFFFFW
WFFFFFFFEFFFFW
WFFFFFFFFFFFFW
WWWWWWWWWWWWWW
